20 22 1 2
15 15 15 15 15 15 15 15 15 15 15 15 15 15 15 15 15 15 15 15
15 8 8 8 8 8 8 8 8 8 8 8 8 8 8 8 8 8 8 15
15 7 7 7 7 7 7 7 7 7 7 7 7 7 7 7 7 7 7 15
15 7 7 7 7 7 7 7 7 7 7 7 7 7 7 7 7 7 7 15 
15 7 7 7 7 7 7 7 7 7 7 7 7 7 7 7 7 7 7 15 
15 7 7 7 7 7 7 7 7 7 7 7 7 7 7 7 7 7 7 15 
15 7 7 7 7 7 7 7 7 7 7 7 7 7 7 7 7 7 7 15
15 7 7 7 7 7 7 7 7 7 7 7 7 7 7 7 7 7 7 15
15 7 7 7 7 7 7 7 7 7 7 7 7 7 7 7 7 7 7 15
15 7 7 7 7 7 7 7 7 7 7 7 7 7 7 7 7 7 7 15
15 7 7 7 7 7 7 7 7 7 7 7 7 7 7 7 7 7 7 15 
15 7 7 7 7 7 7 7 7 7 7 7 7 7 7 7 7 7 7 15 
15 7 7 7 7 7 7 7 7 7 7 7 7 7 7 7 7 7 7 15 
15 7 7 7 7 7 7 7 7 7 7 7 7 7 7 7 7 7 7 15
15 7 7 7 7 7 7 7 7 7 7 7 7 7 7 7 7 7 7 15 
15 7 7 7 7 7 7 7 7 7 7 7 7 7 7 7 7 7 7 15 
15 7 7 7 7 7 7 7 7 7 7 7 7 7 7 7 7 7 7 15 
15 7 7 7 7 7 7 7 7 7 7 7 7 7 7 7 7 7 7 15 
15 7 7 7 7 7 7 7 7 7 7 7 7 7 7 7 7 7 7 15 
15 8 8 8 8 8 8 7 7 7 8 8 8 8 8 8 8 8 8 15
15 8 8 8 8 8 8 7 7 7 8 8 8 8 8 8 8 8 8 15
15 15 15 15 15 15 15 7 7 7 15 15 15 15 15 15 15 15 15 15  

4 	4  15 5  0
4 	7  7  19 0
